000000000000000000000000000000
000000000000000000000000000000
000000000000000000000000000000
000000222222220000000000000000
000000202000020000000000000000
000002202000020000000000000000
000002152220020000000000000000
000002552000020000000000000000
000002200005020000000000000000
000000200000020000000000000000
000000200004020000000000000000
000000200000020000000000000000
000000222222220000000000000000
000000000000000000000000000000
000000000000000000000000000000
000000000000000000000000000000
000000000000000000000000000000
000000000000000000000000000000
000000000000000000000000000000
000000000000000000000000000000
000000000000000000000000000000
000000000000000000000000000000
000000000000000000000000000000
000000000000000000000000000000
000000000000000000000000000000
000000000000000000000000000000
000000000000000000000000000000
000000000000000000000000000000
000000000000000000000000000000
000000000000000000000000000000
